........#.....#...........................
#####...#.....#...........................
....#...#.....#...........................
....#.........#...........................
....######....#...........................
..............#...........................
..............#...........................
..............#...........................
..............#...........................
..........................................
